pppsssshhh…  The protective tinted glass of the pod door lifts off of your body.  You blink your eyes as you slowely drift into conciousness.  You have a massive headache and the lights in this room hurt your eyes.  Even in zero gravity, you strugle to clamber out of your sleeping pod but your muscles have atrophied slightly making it difficult.  The moment you exit the pod, the sleeping pod folds itself up and becomes flush with the floor.

TroubleOnSpaceShip1337
An Interactive Fiction by Rafe McAtee
Release 1 / Serial number 130226 / Inform 7 build 6G60 (I6/v6.32 lib 6/12N) SD

recesitation chamber

>n
corridor

>s
recesitation chamber