pppsssshhh…  The protective tinted glass of the pod door lifts off of your body.  You blink your eyes as you slowely drift into conciousness.  You have a massive headache and the lights in this room hurt your eyes.  Even in zero gravity, you strugle to clamber out of your sleeping pod but your muscles have atrophied slightly making it difficult.  The moment you exit the pod, the sleeping pod folds itself up and becomes flush with the floor.  There is a closet door to the east and a space ship door to the north.

TroubleOnSpaceShip1337
An Interactive Fiction by Rafe McAtee
Release 1 / Serial number 130306 / Inform 7 build 6G60 (I6/v6.32 lib 6/12N) SD

recesitation chamber
In zero gravity, there is no decernable floor or cealing. You are in a cubicaly shaped room, all six of the walls are clean and bright white.  centered on each wall is a square light flush with the walls.  There is a computer and a digital clock built into one of the walls.

>wait
Time passes.

* * *

>press button
The monitor starts up.  It displayes a map of the ship.

* * *

>x monitor
This is a small 6x4 screen.

>x screen
This is a small 6x4 screen.

>push button
The monitor starts up.  It displayes a map of the ship.  A computerized voice starts to talk.  Hello adventurer, I am space ship 1337.  I have temporarily awoken you from suspended unconciousness because of external dammage to my starboard tragectory adjustation thruster.  -Estimating time before catostrophic consequences.-  Potential danger detected.  Collision will occure at 4:35 am, November 3, 2525.  The current time is 12:52 pm, November 1, 2525.  Opening accesible rooms.

>x screen
This is a small 6x4 screen.

>x monitor
This is a small 6x4 screen.

>push button
Nothing happens.

* * *

>x button
This is a solitary button.

>push button
The monitor starts up.  It displayes a map of the ship

* * *

>n
(first opening the space ship door)
It seems to be locked.

>s
recesitation chamber

>e
supply closet

>w
recesitation chamber

>n
corridor

>n
cockpit

>s
corridor

>w
You can't go that way.

>w
You can't go that way.

>e
You can't go that way.

>w
You can't go that way.

>ew
That's not a verb I recognise.

>w
You can't go that way.

* * *

>ew
That's not a verb I recognise.

>e
You can't go that way.

>s
recesitation chamber

>w
airlock

>w
deep space

>w
You can't go that way.

>e
airlock

>e
recesitation chamber

>e
supply closet

* * *

>n
(first opening the space ship door)
It seems to be locked.

>e
(first opening the closet door)
It seems to be locked.

* * *

>push button
The monitor starts up.  It displayes a map of the ship.  A computerized voice starts to talk.  Hello adventurer, I am space ship 1337.  I have temporarily awoken you from suspended unconciousness because of external dammage to my starboard tragectory adjustation thruster.  -Estimating time before catostrophic consequences.-  Potential danger detected.  Collision will occure at 12:49 pm, November 2, 2525.  The current time is 12:52 pm, November 1, 2525.  Opening accesible rooms.

>x monitor
The screen displayes a map of the ship titled "Starboad Wing".  According to the map, you are in the recesitation chamber.  There is a supply locker to the east, a corridor to the north, an airlock to the west of the corridor, and an off limits room to the north of the corridor.  The rest of the ship is greyed out and unlabeled.

>n
(first opening the space ship door)

corridor
You can see a space ship door here.

>x space ship door
This is a big metal door, painted the same color as all of the walls.

* * *

>n
(first opening the space ship door)
It seems to be locked.

>push button
The monitor starts up.  It displayes a map of the ship.  A computerized voice starts to talk.  Hello adventurer, I am space ship 1337.  I have temporarily awoken you from suspended unconciousness because of external dammage to my starboard tragectory adjustation thruster.  -Estimating time before catostrophic consequences.-  Potential danger detected.  Collision will occure at 12:49 pm, November 2, 2525.  The current time is 12:51 pm, November 1, 2525.  Opening accesible rooms.

>n
(first opening the space ship door)

corridor
You can see an inner door and an intimidating door here.

>e
(first opening the inner door)

airlock
You can see an outer door and an inner door here.

>e
(first opening the outer door)

outer space
You can see an outer door here.

>w
airlock
You can see an outer door and an inner door here.

>e
outer space
You can see an outer door here.

* * *

>push button
The monitor starts up.  It displayes a map of the ship.  A computerized voice starts to talk.  Hello adventurer, I am space ship 1337.  I have temporarily awoken you from suspended unconciousness because of external dammage to my starboard tragectory adjustation thruster.  -Estimating time before catostrophic consequences.-  Potential danger detected.  Collision will occure at 12:49 pm, November 2, 2525.  The current time is 12:50 pm, November 1, 2525.  Opening accesible rooms.

>x monitor
The screen displayes a map of the ship titled "Starboad Wing".  According to the map, you are in the recesitation chamber.  There is a supply closet to the east, a corridor to the north, an airlock to the west of the corridor, and an off limits room to the north of the corridor.  The rest of the ship is greyed out and unlabeled.

>push button
Nothing happens.

* * *

>push button
The monitor starts up.  It displayes a map of the ship.  A computerized voice starts to talk.  Hello adventurer, I am space ship 1337.  I have temporarily awoken you from suspended unconciousness because of external dammage to my starboard tragectory adjustation thruster.  -Estimating time before catostrophic consequences.-  Potential danger detected.  Collision will occure at 12:49 pm, November 2, 2525.  The current time is 12:50 pm, November 1, 2525.  Opening accesible rooms.

>w
You can't go that way.

>e
(first opening the closet door)

supply locker
You are in a small cubical room.  All of the walls are clean and white.  There is a dim light brdering the only door.

You can see a space suit here.

* * *

>push button
The monitor starts up.  It displayes a map of the ship.  A computerized voice starts to talk.  Hello adventurer, I am space ship 1337.  I have temporarily awoken you from suspended unconciousness because of external dammage to my starboard tragectory adjustation thruster.  -Estimating time before catostrophic consequences.-  Potential danger detected.  Collision will occure at 12:49 pm, November 2, 2525.  The current time is 12:50 pm, November 1, 2525.  Opening accesible rooms.

>n
(first opening the space ship door)

corridor
You can see an inner door and an intimidating door here.

* * *

>e
(first opening the inner door)

airlock
You can see an outer door and an inner door here.

>e
(first opening the outer door)
The lack of air pressure makes you explode.

    *** You have died ***

In that game you scored 0 out of a possible 1337, in 4 turns.

Would you like to RESTART, RESTORE a saved game, QUIT or UNDO the last command?

* * *

>push button
The monitor starts up.  It displayes a map of the ship.  A computerized voice starts to talk.  Hello adventurer, I am space ship 1337.  I have temporarily awoken you from suspended unconciousness because of external dammage to my starboard tragectory adjustation thruster.  -Estimating time before catostrophic consequences.-  Potential danger detected.  Collision will occure at 12:49 pm, November 2, 2525.  The current time is 12:50 pm, November 1, 2525.  Opening accesible rooms.

>e
(first opening the closet door)

supply locker
You are in a small cubical room.  All of the walls are clean and white.  There is a dim light brdering the only door.

You can see a space suit here.

>take space suit
Taken.

>wear space suit
You can't wear that!

* * *

>x clock
It is 12:50 pm, November 1, 2525.

>wait
Time passes.

>x clock
It is 12:57 pm, November 1, 2525.

>wait
Time passes.

>x clock
It is 12:59 pm, November 1, 2525.

* * *

>x clock
It is 1:22 am November 2st 2525.

>x clock
It is 1:23 am November 2st 2525.

* * *

>x clock
It is 12:53 pm, November 1, 2525.

>xcomputer
That's not a verb I recognise.

>x computer
This is not much of a computer, Just one button and a small 4x6 monitor.  It is built into the wall.

>push button
You can't see any such thing.

* * *

>x clock
It is 12:50 pm, November 1, 2525.

>x digital clock
You can't see any such thing.

* * *

>x clock
It is 9:02 am November 1st 2525.

* * *

>e
(first opening the closet door)
It seems to be locked.