pppsssshhh…  The protective tinted glass of the pod door lifts off of your body.  You blink your eyes as you slowly drift into consciousness.  You have a massive headache and the lights in this room hurt your eyes.  Even in zero gravity, you struggle to clamber out of your sleeping pod but your muscles have atrophied slightly making it difficult.  The moment you exit the pod, the sleeping pod folds itself up and becomes flush with the floor.  There is a closet door to the east and a space ship door to the north.

TroubleOnSpaceShip1337
An Interactive Fiction by Rafe McAtee
Release 1 / Serial number 130318 / Inform 7 build 6G60 (I6/v6.32 lib 6/12N) SD

recesitation chamber
In zero gravity, there is no discernible floor or ceiling. You are in a cubically shaped room, all six of the walls are clean and bright white.  centered on each wall is a square light flush with the walls.  There is a computer and a digital clock built into one of the walls.

You can see a space ship door and a closet door here.

>wait
Time passes.

>wait
Time passes.

>x clock
It is 1:11 pm, November 2, 2525.

* * *

>press button
The monitor starts up.  It displayes a map of the ship.  A computerized voice starts to talk.  Hello adventurer, I am space ship 1337.  I have temporarily awoken you from suspended unconciousness because of external dammage to my starboard tragectory adjustation thruster.  -Estimating time before catostrophic consequences.-  Potential danger detected.  Collision will occure at 12:40 pm, November 3, 2525.  The current time is 12:50 pm, November 1, 2525.  Opening accesible rooms.  When you have finished fixing my starboard tragectory adjustion thruster, please return to the sleeping pod.

>e
(first opening the closet door)

supply locker
You are in a small cubical room.  All of the walls are clean and white.  There is a dim light brdering the only door.  There is a note on the wall and a space suit folded on the floor.

You can see a spacesuit and a note here.

>x note
This is a hand written note attached to the wall with a peice of electrical tape.  It reads please do not urinate in the suit.

>take all
There are none at all available!

>take tape
Taken.

>w
recesitation chamber
In zero gravity, there is no decernable floor or cealing. You are in a cubicaly shaped room, all six of the walls are clean and bright white.  centered on each wall is a square light flush with the walls.  There is a computer and a digital clock built into one of the walls.

>n
(first opening the space ship door)

corridor
The walls are all clean and white.  There are three cirular lights built flush with the walls.  There is a window facing outwars.  There is a panel knocked off of the wall towards the outside of the ship revealing a hole.  It was likely knocked off by an impact of some kind.

You can see an inner door, an intimidating door, a metal panel and a frayed wire here.

* * *

>y is
I only understood you as far as wanting to y.

>x wire
This is some exposed wire wich is disconected.

* * *

>x self
You are a thin human in his late teens.

>look
recesitation chamber
In zero gravity, there is no discernible floor or ceiling. You are in a cubically shaped room, all six of the walls are clean and bright white.  centered on each wall is a square light flush with the walls.  There is a computer and a digital clock built into one of the walls.

You can see a space ship door and a closet door here.

>x computer
This is not much of a computer, Just one button and a small 4x6 monitor.  It is built into the wall.

>press button
The monitor starts up.  It displays a map of the ship.  A computerized voice starts to talk.  Hello adventurer, I am space ship 1337.  I have temporarily awoken you from suspended unconsciousness because of external damage to my starboard trajectory adjusting thruster.  -Estimating time before catastrophic consequences.-  Potential danger detected.  Collision will occur at 12:40 pm, November 3, 2525.  The current time is 12:53 pm, November 1, 2525.  Opening accessible rooms.  When you have finished fixing my starboard trajectory adjusting thruster, please return to the sleeping pod.

>look
recesitation chamber
In zero gravity, there is no discernible floor or ceiling. You are in a cubically shaped room, all six of the walls are clean and bright white.  centered on each wall is a square light flush with the walls.  There is a computer and a digital clock built into one of the walls.

You can see a space ship door and a closet door here.

>x clock
It is 12:55 pm, November 1, 2525.

>x light
Which do you mean, the square light or the circular light?

>square
They are flush to the wall and very bright.

>x circular
These are flush to the wall and on.

>x closet
This is a standard sized door labeled supply locker.

>open closet
You open the closet door.

>look
recesitation chamber
In zero gravity, there is no discernible floor or ceiling. You are in a cubically shaped room, all six of the walls are clean and bright white.  centered on each wall is a square light flush with the walls.  There is a computer and a digital clock built into one of the walls.

You can see a space ship door and a closet door here.

>x closet
This is a standard sized door labeled supply locker.

>go closet
supply locker
You are in a small cubical room.  All of the walls are clean and white.  There is a dim light bordering the only door..

You can see a closet door, a spacesuit and a note here.

>take spacesuit
Taken.

>x note
This is a hand written note attached to the wall with a piece of electrical tape.  It reads please do not urinate in the suit.

* * *

>i
You are carrying:
  a note
  a spacesuit

>look
supply locker
You are in a small cubical room.  All of the walls are clean and white.  There is a dim light bordering the only door..

You can see an electrical tape and a closet door here.

>x tape
A piece of electrical tape.

* * *

>look
supply locker
You are in a small cubical room.  All of the walls are clean and white.  There is a dim light bordering the only door..

You can see a closet door here.

>go closet
recesitation chamber
In zero gravity, there is no discernible floor or ceiling. You are in a cubically shaped room, all six of the walls are clean and bright white.  centered on each wall is a square light flush with the walls.  There is a computer and a digital clock built into one of the walls.

You can see a closet door and a space ship door here.

>go spaceship door
You can't see any such thing.

>open space ship door
You open the space ship door.

>go space ship door
corridor
The walls are all clean and white.  There are three cirular lights built flush with the walls.  There is a window facing outwards.  There is also a glass case containing a crowbar.

You can see an inner door, an intimidating door, a space ship door and a crowbar here.

>x window
The circular window looks out onto a beautiful scene of stars.

>x cube
You can't see any such thing.

>x crowbar
You see nothing special about the crowbar.

>take crowbar
The crowbar is behind thick glass.

>break glass
Violence isn't the answer to this one.

>i
You are carrying:
  an electrical tape
  a note
  a spacesuit

>x inner door
You see nothing special about the inner door.

* * *

>go inner door
You should be careful to operate the airlock doors correctly.

>l
airlock
This is an airlock that leads to outerspace.  There are red warning lights lining both doors.

You can see an outer door and an inner door here.

>w
(first opening the outer door)
The lights dim and red lights begin flashing.  A robot voice begins blaring.  Warning, atmosphere dangerously uninhabitable!

outer space
You are surrounded by a beautiful scene of starts.  The thrusters of the ship are currently off.  They were likely shut down in order to delay the imminent collision.  This makes it possible for you to hold on to the side of the ship and not float off into deep space, however you are still to afraid to traverse the outside of the ship.  From the outside, the space ship is covered in tiled pieces of metal.  You can see a section where there is a huge dent in the ship.  It is within arms reach.

You can see an outer door here.

The lack of air pressure makes you explode.

    *** You have died ***

In that game you scored 0 out of a possible 1337, in 34 turns.

Would you like to RESTART, RESTORE a saved game, QUIT or UNDO the last command?

>undo
airlock
[Previous turn undone.]

>put on space suit
You put on the spacesuit.

>look
airlock
This is an airlock that leads to outerspace.  There are red warning lights lining both doors.

You can see an outer door and an inner door here.

>close inner door
You close the inner door.

* * *

>go outer door
outer space
You are surrounded by a beautiful scene of starts.  The thrusters of the ship are currently off.  They were likely shut down in order to delay the imminent collision.  This makes it possible for you to hold on to the side of the ship and not float off into deep space, however you are still to afraid to traverse the outside of the ship.  From the outside, the space ship is covered in tiled pieces of metal.  You can see a section where there is a huge dent in the ship.  It is within arms reach.

You can see an outer door here.

>x dent
There are several bent panels but the piece that was hit directly is useless and ready to fall off.

>take piece
You can't see any such thing.

>take panel
You pry away the bent panel revealing a hole and some frayed wires.

>x hole
This is a square shaped hole revealing some frayed wires.

In the hole is a frayed wire.

>x wires
This is some exposed wire which is disconnected.

>put wires together
I didn't understand that sentence.

>connect wires
That's not a verb I recognise.

>use tape on wires
I didn't understand that sentence.

>tape wires
You wrap the electrical tape around the frayed wire.

>x hole
This is a square shaped hole revealing some frayed wires.

In the hole is a frayed wire.

>x wires
This is a piece of wire which you fixed with some tape.

>i
You are carrying:
  a bent panel
  a note
  a spacesuit (being worn)

>put panel on hole
Putting things on the hole would achieve nothing.

>l
outer space
You are surrounded by a beautiful scene of starts.  The thrusters of the ship are currently off.  They were likely shut down in order to delay the imminent collision.  This makes it possible for you to hold on to the side of the ship and not float off into deep space, however you are still to afraid to traverse the outside of the ship.  From the outside, the space ship is covered in tiled pieces of metal.  You can see a section where there is a huge hole in the ship with a frayed wire sticking out.  It is within arms reach.

You can see an outer door here.

>e
The space ship rumbles as the engines start and the space ship begins moving.  You hear the tinkle of broken glass coming from inside of the corridor.  The robotic voice starts to speak again.  Thank you adventurer. Please return to your suspended unconsciousness containment pod.

>close outer door
That's already closed.

* * *

>go inner door
corridor
The walls are all clean and white.  There are three cirular lights built flush with the walls.  There is a window facing outwards.  There is broken a glass case containing a crowbar.

You can see an inner door, an intimidating door, a space ship door and a crowbar here.

* * *

>go spaceship door
You can't see any such thing.

>go space ship door
recesitation chamber
In zero gravity, there is no discernible floor or ceiling. You are in a cubically shaped room, all six of the walls are clean and bright white.  centered on each wall is a square light flush with the walls.  There is a computer and a digital clock built into one of the walls.

You can see a space ship door and a closet door here.

>x computer
This is not much of a computer, Just one button and a small 4x6 monitor.  It is built into the wall.

>press button
Nothing happens.

>n
corridor
The walls are all clean and white.  There are three cirular lights built flush with the walls.  There is a window facing outwards.  There is broken a glass case containing a crowbar.

You can see a space ship door, an inner door and an intimidating door here.

>n
you pry open the door with the crowbar but only open it enough to barely squeeze through.

>look
corridor
The walls are all clean and white.  There are three cirular lights built flush with the walls.  There is a window facing outwards.  There is broken a glass case containing a crowbar.

You can see a space ship door, an inner door and an intimidating door here.

>go indimidating
You can't see any such thing.

>go intimidating
You cannot fit through the gap with your space suit on.

* * *

>go intimidating door
cockpit
This is the cockpit of the ship.  The walls are covered with complicated looking control panels.  There is also a windsheild looking out into space.  There is a electronic book (eBook) in the center of the room which attracts your attention. There is a robot standing in the corner of the room.

You can see an intimidating door here.

>x book
You can't see any such thing.

>x ebook
This is a standard eBook.  It has a small screen and two buttons.  There is a left arrow button and a right arrow button.

>press button
Which do you mean, the right arrow button or the left arrow button?

* * *

>x ebook
This is a standard eBook.  It has a small screen and two buttons.  There is a left arrow button and a right arrow button.

>press right button
The screen turns on.

>x screen
Page 1;  Mission log.  Date: October 7, 2014.  Operation "Species Superiority" has been approved by the white house.  This afternoon, 2000 spaceships armed with nuclear warheads will be launched at planet Kratos in the Kleptoid solar system.  This planet is believed to support life but before any attempts at human population, the indigenous species must be eradicated.

>press right
The text on the screen changes.

>x screen
Page 2; Public media will report this as a scouting mission to the potential life harboring planet.  Each one of the 2000 space ships will carry a human, male fetus to grow in suspended animation.  These men will have the cognitive abilities to fix most physical problems unfixable by the space ship's AI.

>press right
The text on the screen changes.

>x screen
Page 3; expected date of arrival: September 10, 2075.  Nuclear radiation will fade and planet Kratos will be habitable by the year 2175.  At this time the first generations of humans will begin populating the new planet.

>press right
The text on the screen changes.

* * *

>x screen
Page 3; expected date of arrival: September 10, 2075.  Nuclear radiation will fade and planet Kratos will be habitable by the year 2175.  At this time the first generations of humans will begin populating the new planet.

>look
cockpit
This is the cockpit of the ship.  The walls are covered with complicated looking control panels.  There is also a windsheild looking out into space.  There is a electronic book (eBook) in the center of the room which attracts your attention. There is a robot standing in the corner of the room.

You can see an intimidating door here.

>x windsheild
The windsheild looks out over a beautiful scene of stars.

>x robot
this is a stationary robot designed with human features.  This model has no buttons on it and instead responds to voice commands.

>talk to robot
Hello human.  I am auto pilot number 1337.  Current destination set to planet kratos.  you may now input new destination.

>earth
That's not a verb I recognise.

>go earth
You can't see any such thing.

>input earth
I didn't understand that sentence.

>look
cockpit
This is the cockpit of the ship.  The walls are covered with complicated looking control panels.  There is also a windsheild looking out into space.  There is a electronic book (eBook) in the center of the room which attracts your attention. There is a robot standing in the corner of the room.

You can see an intimidating door here.

>input new destination
You tell the robot to change the ships route to Earth and it responds positively.

[Your score has just gone up by one thousand, three hundred and thirty-seven points.]

>talk to robot
Hello human.  I am auto pilot number 1337.  Current destination set to planet Earth.  you may now input new destination.

>look
cockpit
This is the cockpit of the ship.  The walls are covered with complicated looking control panels.  There is also a windsheild looking out into space.  There is a electronic book (eBook) in the center of the room which attracts your attention. There is a robot standing in the corner of the room.

You can see an intimidating door here.

>s
corridor
The walls are all clean and white.  There are three cirular lights built flush with the walls.  There is a window facing outwards.  There is broken a glass case containing a crowbar.

You can see an intimidating door, a space ship door and an inner door here.

>s
recesitation chamber
In zero gravity, there is no discernible floor or ceiling. You are in a cubically shaped room, all six of the walls are clean and bright white.  centered on each wall is a square light flush with the walls.  There is a computer and a digital clock built into one of the walls.

You can see a space ship door and a closet door here.

>x pod
This is the egg shaped pod which you climbed out of and is no longer hidden in the floor.

>climb into pod
You can't see any such thing.

>go pod
You climb in and drift off to sleep.

    *** You have won ***

In that game you scored 1337 out of a possible 1337, in 85 turns.

Would you like to RESTART, RESTORE a saved game, QUIT or UNDO the last command?

* * *

>x walls
They are a clinical white.  They are made of smooth hard material similar to a day erase board.

>x light
Which do you mean, the square light or the circular light?

>circular light
These are flush to the wall and on.

>x computer
This is not much of a computer, Just one button and a small 4x6 monitor.  It is built into the wall.

>x button
This is a solitary button.

>push button
The monitor starts up.  It displays a map of the ship.  A computerized voice starts to talk.  Hello adventurer, I am space ship 1337.  I have temporarily awoken you from suspended unconsciousness because of external damage to my starboard trajectory adjusting thruster.  -Estimating time before catastrophic consequences.-  Potential danger detected.  Collision will occur at 12:40 pm, November 3, 2525.  The current time is 12:54 pm, November 1, 2525.  Opening accessible rooms.  When you have finished fixing my starboard trajectory adjusting thruster, please return to the sleeping pod.

>x closet
This is a standard sized door labeled supply locker.

* * *

>open closet
You open the closet door.

>l
recesitation chamber
In zero gravity, there is no discernible floor or ceiling. You are in a cubically shaped room, all six of the walls are clean and bright white.  centered on each wall is a square light flush with the walls.  There is a computer and a digital clock built into one of the walls.

You can see a space ship door and a closet door here.

>look inside closet
You find nothing of interest.

>l
recesitation chamber
In zero gravity, there is no discernible floor or ceiling. You are in a cubically shaped room, all six of the walls are clean and bright white.  centered on each wall is a square light flush with the walls.  There is a computer and a digital clock built into one of the walls.

You can see a space ship door and a closet door here.

>go through door
Which do you mean, the space ship door or the closet door?

>closet door
supply locker
You are in a small cubical room.  All of the walls are clean and white.  There is a dim light bordering the only door..

You can see a closet door, a spacesuit and a note here.

>x light
This is the lighting for the room.

>x spacesuit
This is a cool one piece space suit with a glass dome helmet.

>wear spacesuit
(first taking the spacesuit)
You put on the spacesuit.

>x note
This is a hand written note attached to the wall with a piece of electrical tape.  It reads please do not urinate in the suit.

>x me
You are a thin human in his late teens.

* * *

>e
(first opening the closet door)
It seems to be locked.

>push button
The monitor starts up.  It displays a map of the ship.  A computerized voice starts to talk.  Hello adventurer, I am space ship 1337.  I have temporarily awoken you from suspended unconsciousness because of external damage to my starboard trajectory adjusting thruster.  -Estimating time before catastrophic consequences.-  Potential danger detected.  Collision will occur at 12:40 pm, November 3, 2525.  The current time is 12:51 pm, November 1, 2525.  Opening accessible rooms.  When you have finished fixing my starboard trajectory adjusting thruster, please return to the sleeping pod.

>e
(first opening the closet door)

supply locker
You are in a small cubical room.  All of the walls are clean and white.  There is a dim light bordering the only door..

You can see a closet door, a spacesuit and a note here.

>take all
(the spacesuit)
Taken.

>put on space suit
You put on the spacesuit.

>w
recesitation chamber
In zero gravity, there is no decernable floor or cealing. You are in a cubicaly shaped room, all six of the walls are clean and bright white.  centered on each wall is a square light flush with the walls.  There is a computer and a digital clock built into one of the walls.

>n
(first opening the space ship door)

corridor
You can see an inner door and an intimidating door here.

>w
(first opening the inner door)

airlock
You can see an outer door and an inner door here.

>w
(first opening the outer door)

outer space
You can see an outer door here.

>take off spacesuit
The lack of air pressure makes you explode.

    *** You have died ***

In that game you scored 0 out of a possible 1337, in 10 turns.

Would you like to RESTART, RESTORE a saved game, QUIT or UNDO the last command?

* * *

>e
(first opening the closet door)

supply locker
You are in a small cubical room.  All of the walls are clean and white.  There is a dim light bordering the only door..

You can see a closet door, a spacesuit and a note here.

>x note
This is a hand written note attached to the wall with a piece of electrical tape.  It reads please do not urinate in the suit.

* * *

>put on suit
(first taking the spacesuit)
You put on the spacesuit.

>w
recesitation chamber
In zero gravity, there is no discernible floor or ceiling. You are in a cubically shaped room, all six of the walls are clean and bright white.  centered on each wall is a square light flush with the walls.  There is a computer and a digital clock built into one of the walls.

You can see a closet door and a space ship door here.

>n
(first opening the space ship door)

corridor
The walls are all clean and white.  There are three cirular lights built flush with the walls.  There is a window facing outwards.  There is also a glass case containing a crowbar.

You can see an inner door, an intimidating door, a space ship door and a glass case (closed) here.

>w
(first opening the inner door)

airlock
This is an airlock that leads to outerspace.  There are red warning lights lining both doors.

You can see an outer door and an inner door here.

>w
(first opening the outer door)
The lights dim and red lights begin flashing.  A robot voice begins blaring.  Warning, atmosphere dangerously uninhabitable!

outer space
You are surrounded by a beautiful scene of starts.  The thrusters of the ship are currently off.  They were likely shut down in order to delay the imminent collision.  This makes it possible for you to hold on to the side of the ship and not float off into deep space, however you are still to afraid to traverse the outside of the ship.  From the outside, the space ship is covered in tiled pieces of metal.  You can see a section where there is a huge dent in the ship.  It is within arms reach.

You can see an outer door here.

>take panel
You can't see any such thing.

>x dent
There are several bent panels but the piece that was hit directly is useless and ready to fall off.

>take panel
You pry away the bent panel revealing a hole and some frayed wires.

>tape wire
You wrap the electrical tape around the frayed wire.

>e
airlock
This is an airlock that leads to outerspace.  There are red warning lights lining both doors.

You can see an outer door and an inner door here.

>w
outer space
You are surrounded by a beautiful scene of starts.  The thrusters of the ship are currently off.  They were likely shut down in order to delay the imminent collision.  This makes it possible for you to hold on to the side of the ship and not float off into deep space, however you are still to afraid to traverse the outside of the ship.  From the outside, the space ship is covered in tiled pieces of metal.  You can see a section where there is a huge hole in the ship with a frayed wire sticking out.  It is within arms reach.

You can see an outer door here.

>e
airlock
This is an airlock that leads to outerspace.  There are red warning lights lining both doors.

You can see an outer door and an inner door here.

>we
That's not a verb I recognise.

>e
corridor
The walls are all clean and white.  There are three circular lights built flush with the walls.  There is a window facing outwards.  There is also a glass case containing a crowbar.  The lights are now off and the room is faintly illuminated with a red glow.

You can see an inner door, an intimidating door, a space ship door and a glass case (closed) here.

>w
airlock
This is an airlock that leads to outerspace.  There are red warning lights lining both doors.

You can see an inner door and an outer door here.

>e
corridor
The walls are all clean and white.  There are three circular lights built flush with the walls.  There is a window facing outwards.  There is also a glass case containing a crowbar.  The lights are now off and the room is faintly illuminated with a red glow.

You can see an inner door, an intimidating door, a space ship door and a glass case (closed) here.

* * *

>w
airlock
This is an airlock that leads to outerspace.  There are red warning lights lining both doors.

You can see an inner door and an outer door here.

I beg your pardon?

* * *

>w
recesitation chamber
In zero gravity, there is no discernible floor or ceiling. You are in a cubically shaped room, all six of the walls are clean and bright white.  centered on each wall is a square light flush with the walls.  There is a computer and a digital clock built into one of the walls.

You can see a closet door and a space ship door here.

>n
(first opening the space ship door)

corridor
The walls are all clean and white.  There are three cirular lights built flush with the walls.  There is a window facing outwards.  There is also a glass case containing a crowbar.

You can see an inner door, an intimidating door, a space ship door and a crowbar here.

>w
(first opening the inner door)
You should be careful to operate the airlock doors correctly.

>close inner door
You close the inner door.

>w
(first opening the outer door)

outer space
You are surrounded by a beautiful scene of starts.  The thrusters of the ship are currently off.  They were likely shut down in order to delay the imminent collision.  This makes it possible for you to hold on to the side of the ship and not float off into deep space, however you are still to afraid to traverse the outside of the ship.  From the outside, the space ship is covered in tiled pieces of metal.  You can see a section where there is a huge dent in the ship.  It is within arms reach.

You can see an outer door here.

>x dent
There are several bent panels but the piece that was hit directly is useless and ready to fall off.

* * *

>tape wire
You wrap the electrical tape around the frayed wire.

>e
The space ship rumbles as the engines start and the space ship begins moving.  You hear the tinkle of broken glass coming from inside of the corridor.  The robotic voice starts to speak again.  Thank you adventurer. Please return to your suspended unconsciousness containment pod.

>e
(first opening the inner door)

corridor
The walls are all clean and white.  There are three cirular lights built flush with the walls.  There is a window facing outwards.  There is broken a glass case containing a crowbar.

You can see an inner door, an intimidating door, a space ship door and a crowbar here.

* * *

>n
you pry open the door with the crowbar but only open it enough to barely squeeze through.

>remove space suit
I only understood you as far as wanting to remove the space ship door.

>n
cockpit
This is the cockpit of the ship.  The walls are covered with complicated looking control panels.  There is also a windsheild looking out into space.  There is a electronic book (eBook) in the center of the room which attracts your attention.

You can see an intimidating door here.

>x ebook
This is a standard eBook.  It has a small screen and two buttons.  There is a left arrow button and a right arrow button.

>x eBook
This is a standard eBook.  It has a small screen and two buttons.  There is a left arrow button and a right arrow button.

>x screen
This is a blank eBook screen.

>x control panels
I only understood you as far as wanting to examine the control panel.

>x control panel
The walls are covered with complicated buttons and switched which you cannot comprehend.

>push right button
The screen turns on.

[Your score has just gone up by one thousand, three hundred and thirty-seven points.]

>x screen
Page 1;  Mission log.  Date: October 7, 2014.  Operation "Species Superiority" has been approved by the white house.  This afternoon, 2000 spaceships armed with nuclear warheads will be launched at planet Kratos in the Kleptoid solar system.  This planet is believed to support life but before any attempts at human population, the indigenous species must be eradicated.

>push left button
The text on the screen changes.

>x screen
Page 1;  Mission log.  Date: October 7, 2014.  Operation "Species Superiority" has been approved by the white house.  This afternoon, 2000 spaceships armed with nuclear warheads will be launched at planet Kratos in the Kleptoid solar system.  This planet is believed to support life but before any attempts at human population, the indigenous species must be eradicated.

>push right button
The text on the screen changes.

>x screen
Page 2; Public media will report this as a scouting mission to the potential life harboring planet.  Each one of the 2000 space ships will carry a human, male fetus to grow in suspended animation.  These men will have the cognitive abilities to fix most physical problems unfixable by the space ship's AI.

>push right button
The text on the screen changes.

>x screen
Page 3; expected date of arrival: September 10, 2075.  Nuclear radiation will fade and planet Kratos will be habitable by the year 2175.  At this time the first generations of humans will begin populating the new planet.

>push right button
The text on the screen changes.

>s creen
I only understood you as far as wanting to s.

>s
corridor
The walls are all clean and white.  There are three cirular lights built flush with the walls.  There is a window facing outwards.  There is broken a glass case containing a crowbar.

You can see an intimidating door, a space ship door and an inner door here.

* * *

>s
recesitation chamber
In zero gravity, there is no discernible floor or ceiling. You are in a cubically shaped room, all six of the walls are clean and bright white.  centered on each wall is a square light flush with the walls.  There is a computer and a digital clock built into one of the walls.

You can see a space ship door and a closet door here.

>sleep in sleeping pod
You climb in and drift off to sleep.

    *** You have won ***

In that game you scored 1337 out of a possible 1337, in 34 turns.

Would you like to RESTART, RESTORE a saved game, QUIT or UNDO the last command?

* * *

>n
(first opening the space ship door)
It seems to be locked.

>press button
The monitor starts up.  It displayes a map of the ship.  A computerized voice starts to talk.  Hello adventurer, I am space ship 1337.  I have temporarily awoken you from suspended unconciousness because of external dammage to my starboard tragectory adjustation thruster.  -Estimating time before catostrophic consequences.-  Potential danger detected.  Collision will occure at 12:40 pm, November 3, 2525.  The current time is 12:51 pm, November 1, 2525.  Opening accesible rooms.  When you have finished fixing my starboard tragectory adjustion thruster, please return to the sleeping pod.

>n
(first opening the space ship door)

corridor
The walls are all clean and white.  There are three cirular lights built flush with the walls.  There is a window facing outwars.  There is a panel knocked off of the wall towards the outside of the ship revealing a hole.  It was likely knocked off by an impact of some kind.

You can see an inner door, an intimidating door, a metal panel and a frayed wire here.

>x hole
This is a square shaped hole revealing some frayed wires.

>x wires
This is some exposed wire wich is disconected.

>s
recesitation chamber
In zero gravity, there is no decernable floor or cealing. You are in a cubicaly shaped room, all six of the walls are clean and bright white.  centered on each wall is a square light flush with the walls.  There is a computer and a digital clock built into one of the walls.

>e
(first opening the closet door)

supply locker
You are in a small cubical room.  All of the walls are clean and white.  There is a dim light brdering the only door.  There is a note taped to a space suit folded on the floor.

You can see a spacesuit and a note here.

>take all
There are none at all available!

>take note
Taken.

>x note
This is a hand written note attached to the suit with a peice of electrical tape.  It reads please do not urinate in the suit.

* * *

>n
(first opening the space ship door)
It seems to be locked.

>push button
The monitor starts up.  It displayes a map of the ship.  A computerized voice starts to talk.  Hello adventurer, I am space ship 1337.  I have temporarily awoken you from suspended unconciousness because of external dammage to my starboard tragectory adjustation thruster.  -Estimating time before catostrophic consequences.-  Potential danger detected.  Collision will occure at 12:40 pm, November 3, 2525.  The current time is 12:51 pm, November 1, 2525.  Opening accesible rooms.  When you have finished fixing my starboard tragectory adjustion thruster, please return to the sleeping pod.

>n
(first opening the space ship door)

corridor
The walls are all clean and white.  There are three cirular lights built flush with the walls.  There is a window facing outwars.  There is a panel knocked off of the wall towards the outside of the ship revealing a hole.  It was likely knocked off by an impact of some kind.

You can see an inner door, an intimidating door, a metal panel and a frayed wire here.

>tape wire
You have nothing to fix the frayed wire with.

>n
(first opening the intimidating door)
It seems to be locked.

>s
recesitation chamber
In zero gravity, there is no decernable floor or cealing. You are in a cubicaly shaped room, all six of the walls are clean and bright white.  centered on each wall is a square light flush with the walls.  There is a computer and a digital clock built into one of the walls.

>e
(first opening the closet door)

supply locker
You are in a small cubical room.  All of the walls are clean and white.  There is a dim light brdering the only door.  There is a note on the wall and a space suit folded on the floor.

You can see a spacesuit and a note here.

* * *

>x note
This is a hand written note attached to the wall with a peice of electrical tape.  It reads please do not urinate in the suit.

>take tape
Taken.

* * *

>w
recesitation chamber
In zero gravity, there is no decernable floor or cealing. You are in a cubicaly shaped room, all six of the walls are clean and bright white.  centered on each wall is a square light flush with the walls.  There is a computer and a digital clock built into one of the walls.

>n
corridor
The walls are all clean and white.  There are three cirular lights built flush with the walls.  There is a window facing outwars.  There is a panel knocked off of the wall towards the outside of the ship revealing a hole.  It was likely knocked off by an impact of some kind.

You can see an inner door, an intimidating door, a metal panel and a frayed wire here.

>tape wire
You wrap the electrical tape around the frayed wire.

>x wire
This is a peice of wire which you fixed with some tape.

* * *

>push button
The monitor starts up.  It displays a map of the ship.  A computerized voice starts to talk.  Hello adventurer, I am space ship 1337.  I have temporarily awoken you from suspended unconsciousness because of external damage to my starboard trajectory adjusting thruster.  -Estimating time before catastrophic consequences.-  Potential danger detected.  Collision will occur at 12:40 pm, November 3, 2525.  The current time is 12:50 pm, November 1, 2525.  Opening accessible rooms.  When you have finished fixing my starboard trajectory adjusting thruster, please return to the sleeping pod.

>e
(first opening the closet door)

supply locker
You are in a small cubical room.  All of the walls are clean and white.  There is a dim light bordering the only door..

You can see a closet door, a spacesuit and a note here.

>put on suit
(first taking the spacesuit)
You put on the spacesuit.

>x note
This is a hand written note attached to the wall with a piece of electrical tape.  It reads please do not urinate in the suit.

* * *

>close outer door
That's already closed.

>e
(first opening the inner door)

corridor
The walls are all clean and white.  There are three cirular lights built flush with the walls.  There is a window facing outwards.  There is also a glass case containing a crowbar.

You can see an inner door, an intimidating door, a space ship door and a glass case (closed) here.

>take crowbar
You can't see any such thing.

>open case
You open the glass case, revealing a crowbar.

>take crowbar
Taken.

* * *

>take panel
You pry away the bent panel revealing a hole and some frayed wires.

>drop panel
The bent panel drifts off into space

>i
You are carrying:
  an electrical tape
  a spacesuit (being worn)

>tape wire
You wrap the electrical tape around the frayed wire.

* * *

>e
(first opening the inner door)

corridor
The walls are all clean and white.  There are three cirular lights built flush with the walls.  There is a window facing outwards.  There is broken a glass case containing a crowbar.

You can see an inner door, an intimidating door, a space ship door and a crowbar here.

>x glass case
This glass case is shattered.

* * *

>n
You cannot fit through the gap with your space suit on.

>i
You are carrying:
  a crowbar
  a spacesuit (being worn)

* * *

>i
You are carrying:
  a crowbar
  a spacesuit (being worn)

* * *

>n
(first opening the space ship door)

corridor
The walls are all clean and white.  There are three cirular lights built flush with the walls.  There is a window facing outwards.  There is also a glass case containing a crowbar.

You can see an inner door, an intimidating door, a space ship door and a crowbar here.

>take crowbar
The crowbar is behind thick glass.

>open case
That's not something you can open.

>w
(first opening the inner door)
You should be careful to operate the airlock doors correctly.

* * *

>tape wire
You wrap the electrical tape around the frayed wire.

>e
The space ship rumbles as the engines start and the space ship begins moving.  You hear the tinkle of broken glass coming from inside of the corridor.  The robotic voice starts to speak again.  Thank you adventurer. Please return to your suspended unconsciousness containment pod.

*** Run-time problem P10: Since the glass case is not allowed the property "locked", it is against the rules to try to use it.

* * *

>e
(first opening the closet door)

supply locker
You are in a small cubical room.  All of the walls are clean and white.  There is a dim light bordering the only door..

You can see a closet door, a spacesuit and a note here.

>put on space suit
(first taking the spacesuit)
You put on the spacesuit.

* * *

>i
You are carrying:
  a spacesuit

>put on space suit
You put on the spacesuit.

>x note
This is a hand written note attached to the wall with a piece of electrical tape.  It reads please do not urinate in the suit.

* * *

>e
The space ship rumbles as the engines start and the space ship begins moving.  You hear the tinkle of broken glass coming from inside of the corridor.  The robotic voice starts to speak again.  Thank you adventurer. Please return to your suspended unconsciousness containment pod.

>w
(first opening the outer door)
It seems to be locked.

>e
(first opening the inner door)

corridor
The walls are all clean and white.  There are three cirular lights built flush with the walls.  There is a window facing outwards.  There is broken a glass case containing a crowbar.

You can see an inner door, an intimidating door, a space ship door and a crowbar here.

* * *

>n
The door is shut tightly.

>n
The door is shut tightly.

* * *

>put on space suit
You put on the spacesuit.

>n
you pry open the door with the crowbar but only open it enough to barely squeeze through.

>i
You are carrying:
  a crowbar
  a bent panel
  a spacesuit (being worn)

>n
You cannot fit through the gap with your space suit on.

* * *

>n
cockpit
This is the cockpit of the ship.  The walls are covered with complicated looking control panels.  There is also a windsheild looking out into space.  There is a electronic book (eBook) in the center of the room which attracts your attention.

You can see an intimidating door here.

* * *

>x note
This is a hand written note attached to the wall with a piece of electrical tape.  It reads please do not urinate in the suit.

>put on space suit
(first taking the spacesuit)
You put on the spacesuit.

* * *

>n
you pry open the door with the crowbar but only open it enough to barely squeeze through.

>n
You cannot fit through the gap with your space suit on.

* * *

>n
cockpit
This is the cockpit of the ship.  The walls are covered with complicated looking control panels.  There is also a windsheild looking out into space.  There is a electronic book (eBook) in the center of the room which attracts your attention. There is a robot standing in the corner of the room.

You can see an intimidating door here.

>talk to robot
Hello human.  I am auto pilot number 1337.  Current destination set to planet kratos.  you may now input new destination.

>input new destination
You tell the robot to change the ships route to Earth and it responds positively.

[Your score has just gone up by one thousand, three hundred and thirty-seven points.]

>input
I didn't understand that sentence.

>input new destination
You tell the robot to change the ships route to Kratos and it responds positively.

* * *

>x clock
It is 12:50 pm, November 1, 2525.

>x clock
It is 12:51 pm, November 1, 2525.

>x clock
It is 12:52 pm, November 1, 2525.

>x clock
It is 12:53 pm, November 1, 2525.

>x clock
It is 12:54 pm, November 1, 2525.

>x clock
It is 12:55 pm, November 1, 2525.

>x clock
It is 12:56 pm, November 1, 2525.

>x clock
It is 12:57 pm, November 1, 2525.

I beg your pardon?

>x clock
It is 12:58 pm November 1st 2525.

>x clock
It is 12:59 pm November 1st 2525.

>x clock
It is 1:00 pm November 1st 2525.

I beg your pardon?

I beg your pardon?

>x clock
It is 1:01 pm November 1st 2525.

* * *

>x clock
It is 12:57 pm, November 1, 2525.

>x clock
It is 12:58 pm, November 1, 2525.

>x clock
It is 12:59 pm, November 1, 2525.

>x clock
It is 1:00 pm, November 2, 2525.

>x clock
It is 1:01 pm, November 2, 2525.

>x clock
It is 1:02 pm, November 2, 2525.

>x clock
It is 1:03 pm, November 2, 2525.

>x clock
It is 1:04 pm, November 2, 2525.

>x clock
It is 1:05 pm, November 2, 2525.

>x clock
It is 1:06 pm, November 2, 2525.

>x clock
It is 1:07 pm, November 2, 2525.

>x clock
It is 1:08 pm, November 2, 2525.

I beg your pardon?

>x clock
It is 1:09 pm, November 2, 2525.

>x clock
It is 1:10 pm, November 2, 2525.

>x clock
It is 1:11 pm, November 2, 2525.

>x clock
It is 1:12 pm, November 2, 2525.

>x clock
It is 1:13 pm, November 2, 2525.

>x clock
It is 1:14 pm, November 2, 2525.

I beg your pardon?

>x clock
It is 1:15 pm, November 2, 2525.