pppsssshhh…  The protective tinted glass of the pod door lifts off of your body.  You blink your eyes as you slowly drift into consciousness.  You have a massive headache and the lights in this room hurt your eyes.  Even in zero gravity, you struggle to clamber out of your sleeping pod but your muscles have atrophied slightly making it difficult.  The moment you exit the pod, the sleeping pod folds itself up and becomes flush with the floor.  There is a closet door to the east and a space ship door to the north.

TroubleOnSpaceShip1337
An Interactive Fiction by Rafe McAtee
Release 1 / Serial number 130312 / Inform 7 build 6G60 (I6/v6.32 lib 6/12N) SD

recesitation chamber
In zero gravity, there is no discernible floor or ceiling. You are in a cubically shaped room, all six of the walls are clean and bright white.  centered on each wall is a square light flush with the walls.  There is a computer and a digital clock built into one of the walls.

You can see a space ship door and a closet door here.

>wait
Time passes.

* * *

>press button
The monitor starts up.  It displayes a map of the ship.  A computerized voice starts to talk.  Hello adventurer, I am space ship 1337.  I have temporarily awoken you from suspended unconciousness because of external dammage to my starboard tragectory adjustation thruster.  -Estimating time before catostrophic consequences.-  Potential danger detected.  Collision will occure at 12:40 pm, November 3, 2525.  The current time is 12:50 pm, November 1, 2525.  Opening accesible rooms.  When you have finished fixing my starboard tragectory adjustion thruster, please return to the sleeping pod.

* * *

>e
(first opening the closet door)
It seems to be locked.

>push button
The monitor starts up.  It displayes a map of the ship.  A computerized voice starts to talk.  Hello adventurer, I am space ship 1337.  I have temporarily awoken you from suspended unconciousness because of external dammage to my starboard tragectory adjustation thruster.  -Estimating time before catostrophic consequences.-  Potential danger detected.  Collision will occure at 12:49 pm, November 2, 2525.  The current time is 12:51 pm, November 1, 2525.  Opening accesible rooms.

>e
(first opening the closet door)

supply locker
You are in a small cubical room.  All of the walls are clean and white.  There is a dim light brdering the only door.

You can see a spacesuit here.

>take all
(the spacesuit)
Taken.

* * *

>e
(first opening the closet door)

supply locker
You are in a small cubical room.  All of the walls are clean and white.  There is a dim light brdering the only door.

You can see a spacesuit here.

>take spacesuit
Taken.

>put on spacesuit
You put on the spacesuit.

>take off space suit
You can't see any such thing.

>take off spacesuit
You take off the spacesuit.

>put on space suit
You can't see any such thing.

* * *

>e
(first opening the closet door)
It seems to be locked.

>press button
The monitor starts up.  It displayes a map of the ship.  A computerized voice starts to talk.  Hello adventurer, I am space ship 1337.  I have temporarily awoken you from suspended unconciousness because of external dammage to my starboard tragectory adjustation thruster.  -Estimating time before catostrophic consequences.-  Potential danger detected.  Collision will occure at 12:40 pm, November 3, 2525.  The current time is 12:51 pm, November 1, 2525.  Opening accesible rooms.  When you have finished fixing my starboard tragectory adjustion thruster, please return to the sleeping pod.

>e
(first opening the closet door)

supply locker
You are in a small cubical room.  All of the walls are clean and white.  There is a dim light brdering the only door..

You can see a spacesuit and a note here.

>take tape
You can't see any such thing.

>x note
This is a hand written note attached to the wall with a peice of electrical tape.  It reads please do not urinate in the suit.

* * *

>take suit
Taken.

>wear suit
You put on the spacesuit.

>w
recesitation chamber
In zero gravity, there is no decernable floor or cealing. You are in a cubicaly shaped room, all six of the walls are clean and bright white.  centered on each wall is a square light flush with the walls.  There is a computer and a digital clock built into one of the walls.

>n
(first opening the space ship door)

corridor
The walls are all clean and white.  There are three cirular lights built flush with the walls.  There is a window facing outwars.

You can see an inner door and an intimidating door here.

>w
(first opening the inner door)

airlock
This is an airlock that leads to outerspace.  There are red warning lights linning both doors.

You can see an outer door and an inner door here.

>w
(first opening the outer door)
The lights dim and red lights begin flashing.  A robot voice begins blairing.  Warning, atmosphere dangerously uninhabitable!

outer space
You are surrounded by a beatiful scene of starts.  The thrusters of the ship are currently off.  They were likely shut down in order to delay the imminent collision.  This makes it possible for you to hold on to the side of the ship and not float off into deep space, however you are still to afraid to traverse the outside of the ship.  From the outside, the space ship is covered in tiled peices of metal.  You can see a section where there is a huge dent in the ship.  It is within arms reach.

You can see an outer door here.

>x dent
There are several bent panels but the peice that was hit directly is useless and ready to fall off.

>l
outer space
You are surrounded by a beatiful scene of starts.  The thrusters of the ship are currently off.  They were likely shut down in order to delay the imminent collision.  This makes it possible for you to hold on to the side of the ship and not float off into deep space, however you are still to afraid to traverse the outside of the ship.  From the outside, the space ship is covered in tiled peices of metal.  You can see a section where there is a huge dent in the ship.  It is within arms reach.

You can see a bent panel and an outer door here.

>take bent panel
Taken.

>l
outer space
You are surrounded by a beatiful scene of starts.  The thrusters of the ship are currently off.  They were likely shut down in order to delay the imminent collision.  This makes it possible for you to hold on to the side of the ship and not float off into deep space, however you are still to afraid to traverse the outside of the ship.  From the outside, the space ship is covered in tiled peices of metal.  You can see a section where there is a huge dent in the ship.  It is within arms reach.

You can see an outer door here.

>tape frayed wire
You wrap the electrical tape around the frayed wire.

>i
You are carrying:
  a bent panel
  a spacesuit (being worn)

>w
You can't go that way.

>e
airlock
This is an airlock that leads to outerspace.  There are red warning lights linning both doors.

You can see an outer door and an inner door here.

>e
corridor
The walls are all clean and white.  There are three cirular lights built flush with the walls.  There is a panel knocked off of the wall towards the outside of the ship.  It was likely knocked off by an impact of some kind.  The lights are turned off and the room glowes red from the lights in the airlock.

You can see an inner door and an intimidating door here.

>s
recesitation chamber
In zero gravity, there is no decernable floor or cealing. You are in a cubicaly shaped room, all six of the walls are clean and bright white.  centered on each wall is a square light flush with the walls.  There is a computer and a digital clock built into one of the walls.  The six lights are turned off and the room is now lighted dimly red.

* * *

>e
(first opening the closet door)

supply locker
You are in a small cubical room.  All of the walls are clean and white.  There is a dim light brdering the only door..

You can see a spacesuit and a note here.

>x note
This is a hand written note attached to the wall with a peice of electrical tape.  It reads please do not urinate in the suit.

* * *

>n
(first opening the space ship door)
It seems to be locked.

* * *

>w
You can't go that way.

>e
(first opening the closet door)
It seems to be locked.

>push button
The monitor starts up.  It displayes a map of the ship.  A computerized voice starts to talk.  Hello adventurer, I am space ship 1337.  I have temporarily awoken you from suspended unconciousness because of external dammage to my starboard tragectory adjustation thruster.  -Estimating time before catostrophic consequences.-  Potential danger detected.  Collision will occure at 12:49 pm, November 2, 2525.  The current time is 12:52 pm, November 1, 2525.  Opening accesible rooms.

>e
(first opening the closet door)

supply locker
You are in a small cubical room.  All of the walls are clean and white.  There is a dim light brdering the only door.

You can see a spacesuit here.

* * *

>n
(first opening the space ship door)

corridor
The walls are all clean and white.  There are three cirular lights built flush with the walls.  There is a window facing outwars.  There is a panel knocked off of the wall towards the outside of the ship revealing a hole.  It was likely knocked off by an impact of some kind.

You can see an inner door, an intimidating door, a metal panel and a frayed wire here.

>e
You can't go that way.

>w
(first opening the inner door)

airlock
This is an airlock that leads to outerspace.  There are red warning lights linning both doors.

You can see an outer door and an inner door here.

>w
(first opening the outer door)
The lights dim and red lights begin flashing.  A robot voice begins blairing.  Warning, atmosphere dangerously uninhabitable!

outer space
You can see an outer door here.

>e
airlock
This is an airlock that leads to outerspace.  There are red warning lights linning both doors.

You can see an outer door and an inner door here.

>e
corridor
The walls are all clean and white.  There are three cirular lights built flush with the walls.  There is a panel knocked off of the wall towards the outside of the ship.  It was likely knocked off by an impact of some kind.  The lights are turned off and the room glowes red from the lights in the airlock.

You can see an inner door, an intimidating door, a metal panel and a frayed wire here.

>take off space suit
The lack of air pressure makes you explode.

    *** You have died ***

In that game you scored 0 out of a possible 1337, in 14 turns.

Would you like to RESTART, RESTORE a saved game, QUIT or UNDO the last command?

* * *

>x clock
It is 12:50 pm, November 1, 2525.

* * *

>x clock
It is 12:59 pm, November 1, 2525.

>x clock
It is 1:00 pm, November 2, 2525.

The ship hits a floating rock.

    *** You have died ***

In that game you scored 0 out of a possible 1337, in 11 turns.

Would you like to RESTART, RESTORE a saved game, QUIT or UNDO the last command?

>x clock
It is 1:01 pm, November 2, 2525.

* * *

>x clock
It is 1:07 pm, November 2, 2525.

>x clock
It is 1:18 am November 2st 2525.

>x clock
It is 1:19 am November 2st 2525.

>x clock
It is 1:20 am November 2st 2525.

>x clock
It is 1:21 am November 2st 2525.

>x clock
It is 1:22 am November 2st 2525.

* * *

>push button
The monitor starts up.  It displays a map of the ship.  A computerized voice starts to talk.  Hello adventurer, I am space ship 1337.  I have temporarily awoken you from suspended unconsciousness because of external damage to my starboard trajectory adjusting thruster.  -Estimating time before catastrophic consequences.-  Potential danger detected.  Collision will occur at 12:40 pm, November 3, 2525.  The current time is 12:50 pm, November 1, 2525.  Opening accessible rooms.  When you have finished fixing my starboard trajectory adjusting thruster, please return to the sleeping pod.

* * *

>take tape
You can't see any such thing.

>x note
This is a hand written note.  It reads please do not urinate in the suit.